icelandic	english	depends_on	level	dont_confuse	basic_form	related_items	direction	note_bfr_show	note_after_show	literally	should_teach	categories	grammar	importance	show_hint	alternative_id		Laga?
Láttu mig vera.	Leave me alone., Let me be.	að láta	4															
Ég þoli ekki að vera hérna.	I can't stand being here.	að þola	4															
Hvað á ég að gera?	What am I supposed to do?	að eiga að, að gera	1															
Mér líður ekki vel. 	I don't feel good.	að líða, vel	1															
Mér er sama.	I don't care.	sama	3															
Mér er alveg sama.	I don't care at all.	sama	3															
Mér gæti ekki verið meira sama.	I could not care less.	sama	3															
Hverjum er ekki sama?	Who cares?	sama	3															
Er þér sama þó að ég hringi í þig á morgun?	Do you mind if I call you tomorrow?	sama, að hringja	3															
Við erum í stíl.	We are wearing matching outfits.	stíll	4															
Það er í tísku núna.	That is fashionable right now.	tíska	3															
Hvaðan ertu?	Where are you from?	hvaðan	2															
Hvert langar þig að fara?	Where do you want to go?	hvert, að langa	1															
Hvert langar þig að fara á eftir?	Where do you want to go later today?	hvert, á eftir, að langa	1															
Ég fór þangað áðan.	I went there earlier today.		2															
Ég var þar áðan.	I was there earlier today.		1															
Hvernig bíl áttu?, Hvers konar bíl áttu?	What kind of a car do you own?		1															
Hvernig gerir maður þetta?	How does one do this?		1															
Ég á hvergi heima., Ég á ekki heima neins staðar.			3															
Hvað viltu mikið?, Hversu mikið viltu?	How much do you want?		1															
Hvort viltu?	Which of the two items do you want?	hvor	2															
Til hvers er þetta?	What is this for?, What is the purpose of this?		2															
Til hvers?	What for?, For what purpose?		2															
Tíminn líður of hratt.	Time passes too quickly.		2															
Tíminn leið of hratt.	Time passed too quickly.		2															
Ég vil verða betri.	I want to become better.	góður	2						"Betri" is an adjective.									
Þú gerir þetta betur en ég.	You do this better than I do.	vel	1						"Betur" is an adverb, not an adjective.									
Þú ert betri en ég.	You are better than I am.	góður	1						"Betri" is an adjective.									
Ég á ekki bíl.	I don't own a car.		1															
Þú lítur vel út.	You look good.		1															
Ég ætla að koma í sumar.	I'm planning on coming this summer.		1															
að mæla með	to recommend	að mæla með	1															
Ég mæli með því.	I recommend it.	að mæla með	1															
Mælirðu með því?	Do you recommend it?		1															
Hann mælti með því.	He recommended it.		2															
öld	century		2															
Það gerðist á nítjándu öld.	It happened in the 19th century.		2															
Það er tuttugasta og fyrsta öldin.	It's the 21st century.		2															
Var vikan þín góð?	Was your week good?		1															
Er vikan þín búin að vera góð?	Has your week been good?		1															
Það búa margir í New York.	There are many people that live in New York.		1															
margir	many; many people	margur	1															
margt	many things	margur	1															
fullorðinn	adult, grown-up	fullur, að verða	2															
Ég er unglingur.	I am a teenager.	unglingur	2															
Hann er fullorðinn.	He's an adult.	fullorðinn	2															
Hún er fullorðin.	She's an adult.	fullorðinn	2															
Ég ætla að tala við mömmu mína á eftir.	I'm going to talk to my mother later today.		1															
Hvað ætlarðu að gera á eftir?	What are you going to do later today?		1															
Hvað ætlarðu að gera á morgun?	What are you going to do tomorrow?		1															
Hvað ertu að gera?	What are you doing?		1															
Ég kann íslensku og spænsku.	I know Icelandic and Spanish.		1															
Við kynntumst á Spáni.	We first met each other in Spain., We first got to know each other in Spain.		2															
Ég þekki hana ekki vel.	I don't know her well.		1															
Við þekkjumst ekki.	We don't know each other.		1															
Höfum við hist áður?	Have we met each other before?		2		að hittast													
Það er of heitt.	It's too hot.		1															
Það er of kalt.	It's too cold.		1															
Er þér heitt?	Are you feeling hot?		1															
Mér er kalt.	I'm cold., I'm feeling cold.		1															
Mér er kalt af því að ég er ekki með vettlinga.	I'm cold because I don't have mittens.		3		vettlingur													
Honum er of heitt.	He's feeling too hot.		2															
Ég bý á Íslandi.	I live in Iceland.		1															
Ég kann ekki ensku.	I don't know English.	enska	1															
Kannt þú að elda?	Do you know how to cook?		1															
Finnst þér kaffi gott?	Do you like coffee?		1															
Þetta er ótrúlega góð bók.	This book is incredibly good.	ótrúlegur	1															
Býrðu ennþá á Akureyri?, Býrðu enn á Akureyri?	Do you still live in Akureyri?		1															
að bæta	to improve something		3															
að bæta við	to add		2	að bæta														
Viltu bæta einhverju við?	Is there anything you want to add?		3															
Ég þarf að bæta orðaforðann minn.	I need to improve my vocabulary.		4															
Sinatra er ekki jafn frægur og Elvis.	Sinatra is not as famous as Elvis.	jafn	2															
Ég elska þig samt.	I love you nevertheless/nonetheless/still.	samt	2	enn														
Hann sagðist vera upptekinn.	He said that he was busy., He claimed to be busy.	að segjast	2															
Hann sagðist ætla að koma.	He said that he was planning on coming., He said that he would come.	að segjast	2															
Það snjóaði áðan.	It snowed earlier today.	að snjóa, áðan	2															
Takk fyrir að vera svona þolinmóður.	Thank you for being so patient.		2															
Geturðu hringt í mig á eftir?	Can you call me later today?	að hringja	2															
Getum við heyrst á eftir?	Can we hear from each other later today?, Can we talk later today?	að heyrast	2															
Við heyrumst á eftir.	We will hear from each other later today.		2															
Meðfylgjandi er ferilskráin mín.	My resume is attached., In the attached document you will find my resume.	meðfylgjandi, ferilskrá	4						A sentence that is only used in formal emails.			formal						
meðfylgjandi		að fylgja með	4								no							
Ég held að ég sé að verða veikur.	I think I'm becoming sick.		2										vh					
Ég er orðinn veikur.	I've become sick.		2															
Ertu upptekinn á morgun?	Are you busy tomorrow?	upptekinn	1															
upptekinn	busy		1															
Ég er ekki með nein plön.	I don't have any plans.	plan, ekki neinn	1															
Hann fékk sér hamborgara.	He had a hamburger.	að fá sér	2				->											
edrú	sober, not drunk on alcohol		4															
Ég er næstum því jafn stór og þú.	I'm almost as large as you are.	jafn	2															
áhugi	an interest		1	áhyggja														
áhyggjur	worries	áhyggja	1															
Ég hef áhyggjur af þessu.	I'm worried about this.	áhyggja	1	áhugi														
Ég hef áhuga á þessu.	I'm interested in this.	áhugi	1															
Ég hef engan áhuga á þessu.	I'm not interested in this at all.	áhugi	1															
Engar áhyggjur.	No worries.	áhyggja	1															
Ég veit ekki hvort þú hafir tekið eftir því.	I don't know if you noticed it.		3															
Ég vil að þú komir.	I want you to come.		3															
Hvernig líst þér á?	How do you like the looks of this?, Do you approve of this?	að lítast á	1															
Mér líst ekki vel á þetta.	I don't like the looks of this.	að lítast á	1															
Ertu *nokkuð* upptekinn?	Are you busy, *by any chance*?	nokkur	2															
Ertu laus?	Are you available?	laus	1															
Ég er ekki laus í þessari viku.	I'm not available this week.	laus	1															
Heyrirðu í mér?	Can you hear me?	að heyra	1															
Mér leiðist.	I'm bored.	að leiðast, leiðinlegur	2.9		að leiðast													
Okkur leiðist.	We are bored.	Mér leiðist.	3		að leiðast													
Við leiðumst.	We are holding hands., We are holding each other's hand.	að leiða	3.3	Okkur leiðist.	að leiðast				The [[impersonal]] "okkur leiðist" means "we are bored", but the personal "við leiðumst" means "we hold hands".									
Þetta er leiðinlegt.	This is boring., This is tedious.		1															
í mesta lagi	at maximum	mikið	2															
í minnsta lagi	at minimum	lítið	2															
Ég ætla *að leggja af stað* eftir tíu mínútur.	I intend to *get going* in 10 minutes., I intend to *start my trip* in 10 minutes.	að leggja af stað	2															
Geturðu sótt mig?	Can you come pick me up?	að sækja	2															
heimsending	food delivery service	heima, að senda	2	að sækja														
Ég held að ég verði laus.	I think that I will be available.	að verða, laus	3															
Ég er búinn að gleyma því.	I've forgotten it.	að gleyma, búinn	2															
Ég veit ekki hvort það sé hægt.	I don't know if that's possible.	hvort	2															
Hann býr einn.	He lives alone.		1															
Hún býr með foreldrum sínum.	She lives with her parents.		1															
Ertu í stuði fyrir mynd?	Are you in the mood for watching a film?	stuð	1															
Þú hefur rétt fyrir þér.	You're right.	réttur	1															
Þú hefur rangt fyrir þér.	You're wrong.	rangur	1															
vitlaus, rangur	wrong, incorrect		1				<-											
Það er vitlaust., Það er rangt.	That's incorrect.		1															
Segðu honum að hann geti komið klukkan fimm.	Tell him that he can come at 5 o'clock.		3									time	bh					
Ég hef ekki efni á því.	I can't afford it.	efni	2															
Hvernig hefurðu efni á þessu?	How can you afford this?		2															
framburður	pronunciation	að bera fram	2															
að bera fram	to pronounce		2															
Ég trúi því ekki.	I don't believe it.	að trúa	1															
Kærar kveðjur.	Best regards.	kær, kveðja	2					Used at the end of emails.		Cherished greetings.								
Er mikið að gera í vinnunni?		vinna, mikill, að gera, mikið að gera	1															
áðan	earlier today		1	áður														
áður	previously, before		1	áðan														
Þetta er ekkert smá gott.	This is very good!	ekkert smá	3				->											
ekkert smá	very much	smá, enginn	2				->		An understatement is used for emphasis. "Nothing little" implies greatness.									
Hann var ekkert smá pirraður.	He was super annoyed	ekkert smá	2				->											
Ég kann smá spænsku.	I know a little bit of Spanish.		1															
Ég vissi það ekki.	I didn't know that.	að vita	2															
Ég á ekki fyrir mat.	I don't have sufficient money to be able to afford food.	að eiga fyrir	3				->											
Hver heldurðu eiginlega að þú sért?	Who do you think you are?!	eiginlega	3															
Ekki koma inn!	Don't come in!		2															
Hvað meinarðu?	What do you mean?		1															
að sjá eftir einhverju	to regret something	að sjá eftir	3															
Ég sé eftir því að hafa ekki farið.	I regret not having gone.	að sjá eftir	3															
alltaf	always		1	allt of														
allt of mikið	way too much	allt of	1															
Ég borða alltaf mikið.	I always eat a lot.		1															
Ég borða allt of mikið.	I eat way too much.	allt of	1	Ég borða alltaf mikið.														
Það kemur þér ekki við.	That's none of your business.	að koma einhverjum við	2													að koma einhverjum við		
að velta fyrir sér			3															
að gefast upp	to give up, to surrender		2															
Hvað viltu marga poka?	How many bags do you want?	að vilja, poki	1															
poki	a bag		1															
Það kom mér á óvart.	It came as a surprise to me.	óvar	2															
Ég gerði það óvart.	I did it inadvertently., I did it accidentally.	óvar	2															
Hvað áttu við?	What do you mean?, What are you referring to?	að eiga við	2				->											
Hann er á klósettinu.	He's on the toilet.	klósett	2															
Þetta er í *fyrsta skipti* sem ég kem til Íslands.	This is the *first time* I come to Iceland.	skipti	2															
Þetta gengur ekki vel.	This is not going well.	að ganga	1															
Hvernig segir maður X á íslensku?	How do you say X in Icelandic?	að segja	1															
að ganga vel	to be going well		1															
að ganga illa	to be going badly		1															
Mér líður illa.	I feel bad.		1															
Mér líður vel.	I feel good.		1															
Honum líður ekki vel.	He doesn't feel good.		1															
Ég ætla bara að slaka á um helgina.	I'm just going to relax this weekend.	að slaka á, helgi	1															
að slaka á	to relax		1															
helgi	weekend		1															
Hvað ætlarðu að gera um helgina?	What are you going to do this weekend?		1															
Hvað gerðirðu um helgina?	What did you do this weekend?		2															
Ertu á Íslandi?	Are you in Iceland?		1															
Það er gott veður.	There is good weather., The weather is good.		1															
Er veðrið gott?	Is the weather good?		1															
Ætlarðu að fá þér köku?	Are you going to have some cake?		1															
Ég er að borða köku.	I'm eating a cake.		1															
myndband	a video	mynd	1															
Við horfðum á bíómynd áðan.	We watched a film earlier today.		2															
Hvað er það aftur?	What's that again?, Tell me again\, what's that?		2															
Finnst þér það ekki vera góð mynd?	Do you not think that it's a good film?	að finnast	2															
vitlaus	incorrect, wrong; stupid	að vita, laus	1				->											
Ég þarf að fara., Ég verð að fara.	I need to go.		1															
Viltu tala við hann?	Do you want to speak to him?		1															
Ég er í fríi í næstu viku.	I have a vacation next week.	frí	1															
Ég er að vinna.	I'm working.		1															
Það er stundum erfitt.	It's sometimes difficult.		1															
Ég skil að það sé stundum erfitt.	I understand that it is sometimes difficult.		3															
Systir mín var þar á síðast ári. 	My sister was there last year.		2															
Ég horfi aldrei á fréttirnar.	I never watch the news.		2															
Ég veit ekkert um það.	I don't know anything about that.	að vita	1															
Það er ekkert að gerast.	There's nothing going on., There's nothing happening.	að gerast	1															
Mér er alltaf kalt.	I'm always cold.		2															
Ég er í vinnunni.	I'm at work.	vinna	1															
Ég verð í vinnunni þá.	I will be at work at that time.	vinna	1															
Ég sakna þín.	I miss you.	að sakna	3															
Hann er mjög reiður yfir því.	He's very angry about that.	reiður	1															
Hún er reið yfir því.	She's angry about that.	reiður	1															
Er hann nokkuð reiður?	Is he angry\, by any chance?	reiður, nokkuð	4															
ræktin	the gym	að rækta	2							The cultivation								
Ég ætla í ræktina á eftir.	I'm going to the gym later today.	ræktin	2															
Ég er í ræktinni.	I'm at the gym.	ræktin	2															
Hvað þýðir þetta orð?	What does this word mean?		1															
Veistu hvað þetta orð þýðir?	Do you know what this word means?		1															
Hvernig þýðir maður þetta?	How does one translate this?		2															
Ég hlakka til.	I'm looking forward to it.	að hlakka til	2															
Ég ætla að vera þar í fjóra daga.	I'm going to be there for 4 days.		1									time						
Er erfitt að vera kennari?	Is it difficult being a teacher?		1															
Það er erfitt að vera kennari.	It's difficult being a teacher.		1															
að kenna	to teach		1	að kunna														
kennari	a teacher		1															
kennarinn	the teacher		1															
Ég talaði við kennarann minn.	I talked to my teacher.	að tala	2															
Hvað heitir hann?	What's his name?	að heita	1															
að heita	to be named		1	heitur														
auðvitað	of course	að vita, auðveldur	1	auðveldur						Easily known								
Hvað heitir kötturinn þinn?	What's your cat's name?	að heita	1															
Hvar ætlar þú að búa?	Where do you plan on living?	að búa	1															
Er gaman að læra íslensku?	Is learning Icelandic fun?	gaman	1															
Þetta var skemmtileg mynd.	This was a fun/entertaining movie.		1															
Þetta tekur tvo tíma.	This will take two hourse.		1															
Ég kem eftir þrjá tíma.	I will come in 3 hours.		1															
Nemendurnir mínir eru mjög duglegir.	My students are very hardworking.	duglegur, nemandi	2															
smá	a little bit		1															
aðeins meira, smá meira	just a little bit more		1															
Hann hlustar ekki á pabba *sinn*.	He doesn't listen to *his own* dad.		1															
Ég ætla að tala við mömmu *mína*.	I am going to talk to my *mom*.		1															
Ég ætla að tala við mömmu *hans*.	I am going to talk to his *mom*.		1															
Hann ætlar að tala við mömmu *sína*.	He is going to talk to *his own* mom.		1															
Hún ætlar að tala við mömmu *sína*.	She is going to talk to *her own* mom.		1															
Hún ætlar að tala við mömmu *hans*.	She is going to talk to *his* mom.		1															
Hvað ætlar þú að gera í dag?	What do you plan on doing today?		1															
þáttur	a TV show; a TV episode; a part		1															
Átti þátt í því																		
Af hverju ert þú kennari?	Why are you a teacher?		1															
í dag	 today		1															
Þetta er löng bók.	This is a long book.	langur	1															
Myndin er með enskum texta.	The film has English subtitles.	texti, að vera með	2															
Ég skil ekki mikið.	I don't understand much.	að skilja, mikill	1															
Ég skildi ekki mikið.	I didn't understand much.	að skilja, mikill	2															
Ég hitti vini mína áðan.	I met my friends earlier today.	að hitta, vinur	2															
heimsókn	a visit	að heimsækja	1															
heima	at home		1															
að eiga heima einhvers staðar, að búa	to live somewhere	heima, að eiga	1				<-											
Hvar býrðu?, Hvar áttu heima?	Where do you live?		1				<-											
Hvar býrðu?	Where do you live?		1				->											
Hvar áttu heima?	Where do you live?, What's your address?				að eiga heima		->			Where do you have home?								
Ég er heima.	I'm at home.		1															
heimili	a home, a household	heima	3															
Ég er ekki búinn að taka til\, þess vegna er *allt á hvolfi*.	I haven't cleaned up yet\, that's why *the house is a mess*.	á hvolfi	4															
á hvolfi	upside-down; totally disordered		4															
að borða	to eat		1															
borð	a table	að borða	1															
að fá	to get		1															
Í alvöru?	Really?	alvara	1															
stundum	sometimes		1															
Vinur minn vinnur hérna.	My friend works here.	vinur, að vinna	1															
Vinnur vinur þinn ekki hérna?	Doesn't your friend work here?	vinur, að vinna	1															
Hvað ætlar þú að gera í kvöld?	What are you going to do this evening?		1															
Ég horfi bara á spænska þætti.	I only watch Spanish TV shows.	þáttur, spænskur, að horfa	1															
bara	only; just		1	barn, bar														
Mér þykir vænt um þig.	I feel affection for you, I care about you, I feel love for you	að þykja vænt um	2															
Ég er frá Boston. 	I'm from Boston.		1															
Hvenær ætlar þú að koma til Íslands?	When are you going to come to Iceland?		1															
Ég ætla að koma til Íslands í september.	I plan on coming to Iceland in September.		1															
búð	a grocery store, a supermarket		2															
búðin	the grocery store, the supermarket		2															
Ég þarf að fara í búð.	I need to go to a grocery store.		2				->											
Ég þarf að fara í búðina.	I need to go to the grocery store.		2				->											
Ég er í búðinni.	I'm at the grocery store.		2				->											
Hann er úti í búð.	He's at the grocery store.		2				->		"Að vera úti í búð" is a phrase.									
Hann ætlar út í búð.	He plans on going to the grocery store.		2				->		"Að vera úti í búð" is a phrase.									
Ég er úti.	I'm outside.	úti	1															
Ég ætla út.	I'm intend to go outside.	út	1															
Ég fer út.	I'll go outside.	út	1															
Ég var úti áðan.	I was outside earlier today.	úti	1															
Hvað viltu fá?	What do you want to get?	að fá	1															
Ég fer í ræktina fimm sinnum í viku.	I go to the gym 5 times a week.	sinnum, ræktin	2															
Ég fer út í búð einu sinni í viku.	I go to the store once a week.	sinnum, búð	2				->											
úti	outside		1															
út	out; to outside		1	úti														
mjög	very		1	mikið														
mikið	much	mikill	1															
mjög mikið	very much		1															
Við sjáumst fljótt.	See you soon!	að sjást, fljótur	1															
Drekkur þú kaffi?	Do you drink coffee?	að drekka, kaffi	1															
kaffi	coffee		1															
kaffið	the coffee	kaffi	1															
Ég drekk bara vatn.	I only drink water.	að drekka	1															
Hún er alltaf þreytt.	She's always tired.	þreyttur	1															
að vekja	to wake someone up		4	Did yo														
að vakna	to wake up		2															
vakandi	to be awake		2															
að vaka	to stay awake	vakandi	5	að vakna			->											
Ertu vakandi?	Are you awake?		2															
Ég þarf að vakna snemma á morgun.	I need to wake up early tomorrow.		2															
snemma	early; early in the morning		1															
Hann er sofandi.	He's asleep.	sofandi	2															
að sofna	to fall asleep		2	að sofa														
að sofa	to sleep		2	að sofna														
Ég get ekki sofnað. 	I can't fall asleep.	að sofna	2															
Ég gat ekki sofnað.	I couldn't fall asleep.	að sofna	2															
Ég sef of mikið.	I sleep too much.	að sofa	3															
Ég sofnaði í skólanum.	I fell asleep at school.	skóli, að sofna	3															
Ég svaf vel.	I slept well.		3															
Svafstu vel?	Did you sleep well?	að sofa	3															
Þú svafst lengi.	You slept for a long time.	að sofa, lengi	3															
Ég vinn heima.	I work at home.	að vinna, heima	1															
tungumál	a language	tunga, mál	1				->											
tungumál, mál	a language		1				<-											
mál	an issue, a matter; a language		1															
Ekki málið.	No problem.									not the issue								
Það er ekkert mál.	That's no problem.; That is easy.									That is no issue.								
Gott mál.			3				->											
Það er allt í góðu.	Don't worry about it\, it's all good.		3				->											
tunga	a tongue		2															
tungan	the tongue	tunga	2															
Mér er illt í maganum.	My stomach hurts.	illt, magi	2															
Er þér illt?	Do you feel pain in some body part?	illt	2															
Mér er illt í tánni.	My toe hurts.	illt, tá	2															
Honum er illt í tönninni.	His tooth hurts.	illt, tönn	2															
að búa	to live somewhere		1				->											
að búa til	to create, to make		2	að búa														
að búa um rúmið	to make the bed		6															
Þau búa saman.	They live together.		2															
Ég bý hjá foreldrum mínum.	I live at my parents' place., I live with my parents.	að búa, foreldri	2															
kona	a woman; a wife		1															
maður	a man; a person; a husband		1															
Konan mín er tónlistarmaður.	My wife is a musician.	kona, tónlistarmaður	1															
tónlistarmaður	musician	tónlist, maður	1															
að vera			1															
að vera til			1															
að vera til í			1															
tónlist	music	list	1															
Ekki ennþá., Ekki enn.	Not yet.		1															
Hvað ert þú búinn að læra íslensku lengi?	For how long have you been learning Icelandic?	lengi	1															
Ísland	Iceland		1															
íslenska	Icelandic language	Ísland	1															
Hann er góður í íslensku.	He's good at Icelandic.	íslenska	1															
Hann er Íslendingur.	He's an Icelander.	Íslendingur	1															
Íslendingur	an Icelander, an Icelandic person		1															
Hún er Íslendingur.	She's an Icelander.	Íslendingur	1															
Hann er íslenskur.	He is Icelandic.	íslenskur	1															
Hún er íslensk.	She is Icelandic.	íslenskur	1															
að eiga	to own		1	að vera með, að hafa, á														
að eignast	to acquire	að eiga	3						Related to "að eiga"									
Ég á marga vini.	I have many friends.	að eiga	1															
Þú átt marga vini.	You have many friends.	að eiga	1															
Hann á marga vini.	He has many friends.	að eiga	1															
Ég á bíl.	I own a car.	að eiga	1															
Þú átt bíl.	You own a car.	að eiga	1															
Áttu bíl?	Do you own a car?	Þú átt bíl.	1															
Ég á eitt barn.	I have one child.	að eiga, barn, einn	1															
Ég á tvö börn.	I have two children.	að eiga, barn, tveir	1															
Áttu börn?	Do you have children?	að eiga	1															
Ég ætla að eignast börn.	I plan on having children.	að eignast	3							I plan on acquiring a child.								
Það er erfitt að eignast vini á Íslandi.	It's difficult to make friends in Iceland.	að eignast	2							It's difficult to acquire friends in Iceland.								
Hvar býr vinur þinn?	Where does your friend live?		1															
tími	time; a class; an hour		1															
Það tekur tvo tíma.	It takes two hours.	tími	1															
Ég kem eftir einn tíma.	I will come in one hour.	tími	1															
Það tekur langan tíma.	It takes a long time.	tími, langur	1															
Hvað tekur það langan tíma?	How long does it take?	tími, langur	1															
Því miður.	Unfortunately., Sadly.; Sadly not.	því miður	1															
Ég get því miður ekki hjálpað þér.	I can sadly not help you.	því miður	1															
Nei\, því miður.	No\, unfortunately., No\, sadly not.	því miður	1															
Ég þarf því miður *að hætta við*.	I will unfortunately have to *pull out of the plans I had made*/*withdraw*.	að hætta við	3															
að hætta við	to withdraw from plans, to decide to not do something you had planned on doing	að hætta	3															
að hætta	to quit		2															
Ég ætla að hætta að reykja.	I plan on quitting smoking.	að hætta	1															
Ég er hættur að reykja.	I've quit smoking., I no longer smoke.	að hætta	1															
Það er hættulegt.	It's dangerous.	hættulegur	2	að hætta														
Hann er hættur að drekka kók.	He has quit drinking Coke., He no longer drinks Coke.	að hætta, kók, að drekka	1															
Hann er veikur.	He's ill., He's sick.	veikur	1	vika														
Ég var veikur í síðustu viku.	I was ill last week.	veikur, vika	1															
Ég er ekki lengur veikur.	I'm no longer ill.	veikur, lengi	1															
Ég var veikur í langan tíma., Ég var veikur lengi.	I was ill for a long time.	veikur, lengi	1															
Þarftu að vinna í dag?	Do you have to work today?		1															
Ég þarf að vinna í dag.	I have to work today.		1															
að hitta 	to meet someone		1															
að hittast	to meet each other	að hitta 	2															
Viltu hittast á eftir?	Do you want to meet later today?		1															
Viltu hitta hann á eftir?	Do you want to meet him later today?		1															
á eftir	later today	eftir	1	seinna														
seinna	later	seinn	1															
Ég ætla að hitta vin minn á eftir.	I'm going to meet my male friend later today.		1															
Ég ætla að hitta vinkonu mína á eftir.	I'm going to meet my female friend later today.		1															
Þetta er vinur minn.	This is my male friend.		1															
Þetta er vinkona mín.	This is my female friend.		1															
Við hittumst áðan.	We met each other earlier today.		2															
Við hittumst á eftir.	We will meet each other later today.		1															
Ég hitti hann í gær.	I met him yesterday.		1															
Ég hitti hann á morgun.	I will meet him tomorrow.		1															
í kvöld	this evening	kvöld	1															
um kvöld	during the evenings (in general)	kvöld	2	í kvöld														
í gærkvöld	yesterday evening	kvöld, í gær	3															
Ég get það ekki.	I can't.	að geta	1															
Ég get ekki gert það.	I can't do it.	að geta	1															
Gaman að sjá þig.	Nice to see you., It is enjoyable to see you.		1															
Hann er með flott hár.	He has stylish/elegant/impressive hair., His haircut looks good.	flottur, að vera með	1															
Hann er í flottum fötum.	He's wearing stylish/elegant/good-looking clothes.	flottur, föt	1															
Hann býr í stóru húsi.	He lives in a big house.	að búa, stór, hús	1															
föt	clothes		1															
Í hvernig fötum ertu?	What type of clothes are you wearing?	föt, að vera í	1															
Hann er *ber að ofan*.	He is *shirtless*.	ofan	3							He is bare to above (the waist).								
Mér finnst það fyndið.	I find it to be funny.	fyndinn	1															
Finnst þér kjöt gott?	Do you like meat?	kjöt	1															
að gera	to do		1															
að gerast	to happen, to occur	að gera	1															
Hvað gerðist?	What happened?	að gerast	1															
Hvað er að gerast?	What's going on?, What is happening?	að gerast	1															
Ég er með hita.	I have a fever.	hiti, að vera með	1															
Langar þig að koma með?	Do you want to come along?		1				->											
Langar þig að vera með okkur?	Do you want to be with us?	að vera með, við (fn)	1															
ókei	okay		1				<-											
ólétt	pregnant	léttur	3													óléttur		
Finnst þér þetta vera fyndið?	Do you find this funny?	fyndinn	1															
Ég trúi því ekki alveg.	I don't quite believe it.	að trúa, alveg	1															
Hann er *sköllóttur*.	He's *bald*.		4													sköllóttur		
þunnur	thin; with a hangover (referring to alcohol)		3															
fullur	full; drunk on alcohol		2															
Það er öllum sama., Öllum er sama.	Nobody cares.	sama, allir	2															
Við erum *mismunandi*.	We are *different/distinct*.		2						"Mismunandi" describes a *group* of things being distinct from each other, while "öðruvísi" describes *one thing* being different from something else.							mismunandi		
Þú ert *öðruvísi* en ég.	You are *different* from me.		2	mismunandi					"Mismunandi" describes a *group* of things being distinct from each other, while "öðruvísi" describes *one thing* being different from something else.							öðruvísi		
Vinur minn er enskukennari.	My friend is an English teacher.		1															
Ég vinn of mikið.	I work too much.	að vinna, mikill	1															
skárri	less bad, a little better		2	betri														
að skána	to become less bad, to improve slightly; to recover slightly from an illness	skárri	3															
Ertu ekkert að skána?	Are you not at all beginning to recover from your illness?	að skána	3															
Ég er að skána.	I am beginning to recover slightly from my illness.	að skána	3															
Ég er skárri í ensku en dönsku.	I am slightly better at speaking English than Danish (but I am bad at both).	skárri	3															
Ég vona að ég verði búinn að skána fyrir næstu viku.	I hope that I will have recovered slightly from my illness before next week.	að skána, að verða	3															
Ég vona að ég verði skárri í næstu viku.	I hope that I will be slightly better next week., I hope that I will not be as bad next week.	að skána, að verða	3															
Ég vona það.	I hope so.	að vona	2															
Ég var að vonast til þess að ég gæti talað við þig.	I was hoping that I could speak to you.	að vonast, að vona	3									formal						
kærasti	boyfriend	kær	1															
kærasta	girlfriend	kær	1	kærasti														
Ég á *kærasta*.	I have a *boyfriend*.	kærasti	1	kærasta														
Ég á *kærustu*. 	I have a *girlfriend*.	kærasta	1															
Ég ætla að fara með kærastanum mínum til útlanda.	I am going to go with my boyfriend to a foreign country.	útlönd, kærasti	2															
útlönd	foreign countries	út, land	2	úti á landi														
að fara til útlanda	to go abroad, to go to a foreign country	útlönd	2															
að vera í útlöndum	to be abroad, to be in a foreign country	útlönd	2															
útlenska	a foreign language	útlönd	2															
útlendingur	a foreigner	útlönd	2															
Ég er útlendingur.	I am a foreigner.	útlendingur	2															
Þessi mynd er á útlensku.	This film is in a foreign language.	útlenska	2															
Ég er í útlöndum.	I'm abroad., I'm in a foreign country.	útlönd	2															
Ég er úti á landi.	I'm out on the countryside.	úti á landi	2															
að vera úti á landi	to be out on the countryside		2													úti á landi		
Ég er í fríi.	I'm on vacation., I have a vacation.	frí	1															
Ég fer í frí í næstu viku.	I will go on vacation next week.	frí	1															
ókeypis	free of charge	að kaupa	2	frí														
Ég verð í fríi í næstu viku.	I will have a vacation next week.	frí	2															
Hann sagðist myndu hjálpa mér.	He said that he would help me.	að segjast, að munu	4															
Er þetta ókeypis?	Is this for free?		1															
Ætlarðu að kaupa þetta?	Are you going to buy this?	að kaupa	1															
Ég hélt að hann myndi hjálpa mér.	I thought that he would help me.	að hjálpa, að munu	3															
Heldurðu að hann geti hjálpað mér?	Do you think that he can help me?	að hjálpa	3															
Komdu til mín.	Come to me.	að koma	2										bh					
Eigum við að leggja af stað?	Shall we get going?	að eiga að, að leggja af stað	2															
Við ætlum í sund.	We are going swimming., We intend to go swimming.	sund	2															
að heimsækja	to visit	heima, að sækja	1															
Þú ert hálfviti.	You are an idiot.	hálfviti	3									rude						
Djöfullinn sjálfur.	God damn!	djöfull, sjálfur	2				->			The devil himself.								
Andskotinn.	Damn!	andskoti	2				->			The devil (the one who shoots against you, the one who is against you).								
Hvar er hann?	Where is he?	hvar	1															
Hver er þetta?	Who is this?	hver	1															
Við getum ekki gert það.	We cannot do that.		2															
fjölskylda	a family	fjöldi, skyldur	1															
fjölskyldan	the family	fjölskylda	1															
fjölskyldan mín	my family	fjölskylda	1															
Ég er skyldur honum.	I'm related to him.		3													skyldur		
Við erum skyldir.	We are related to each other.	skyldur	3				->											
Eruð þið skyld?	Are you related to each other?		3				->											
Má bjóða þér afritið?	Can I offer you the receipt?	að mega, afrit	2				->					formal						
Viltu afritið?	Do you want the receipt?		2				->									afrit		
Viltu kvittun?	Do you want a receipt?	kvittun	2				->									kvittun		
Hvenær kemstu?	When will you be able to come?	að komast	2															
Kemstu á morgun?	Will you be able to come tomorrow?	að komast	2															
kannski	maybe		1	stundum														
aldrei	never		1	alltaf														
aftur	again		1	aldrei, alltaf														
einu sinni	once	einn	1									number						
tvisvar	twice	tveir	1									number						
þrisvar	three times	þrír	1									number						
fjórum sinnum	four times	fjórir	1									number						
fimm sinnum	five times	fimm	1									number						
sex sinnum	seven times	sex	1									number						
sjö sinnum	seven times	sjö	1									number						
átta sinnum	eight times	átta	1									number						
níu sinnum	nine times	níu	1									number						
Þekkist þið?	Do you guys know each other?	að þekkjast	1															
Ég veit *ekki einu sinni* hver þetta er.	I do *not even* know who this is.	ekki einu sinni	2															
ekki einu sinni	not once; not even! (for emphasis)	einu sinni	2															
Hvað ertu að horfa á?, Á hvað ertu að horfa?	What are you watching?	að horfa á	1															
Ég hitti vin minn áðan.	I met my male friend earlier today.		2															
Komdu út.	Come outside.	að koma	2										bh					
Hann er blindfullur.	He's extremely drunk.	fullur, blindur	3									party						
Hún er blind.	She is blind.	blindur	3															
Hvað í andskotanum ertu að gera?, Hvað í fjandanum ertu að gera?	What the hell are you doing?	andskoti, fjandi	2				->					rude						
Ég hlakka til að sjá þig.	I'm looking forward to seeing you.		2															
fundur	a meeting		1															
Ég þarf að mæta á fund á eftir.	I need to attend a meeting later today., I need to show up at a meeting later today.	fundur, að mæta	2															
Þú mættir ekki í tímann.	You didn't show up in the class.		2															
að mæta	to show up at an event; to meet someone you know on the street		2	að hitta														
Ég mæti í partíið þitt.	I will show up at your party.	að mæta	2															
Ég mætti í partíið þitt.	I showed up at your party.	að mæta	2															
Ég mætti honum áðan.	I encountered him earlier today (on the street or in the hallway)., We walked past each other earlier today.	að mæta	4															
Hann er mættur.	He is present., He is here (and has shown up).	að mæta	3															
Kanntu mörg tungumál?, Kanntu mörg mál?	Do you know many languages?	tungumál, mál	2															
ökuskírteini	a driver's license	að aka, skírteini	3															
ökuskírteinið	the driver's license	ökuskírteini	3															
Ertu með ökuskírteinið þitt?	Do you have your driver's license?	ökuskírteini, að vera með	3															
orðaforði	vocabulary	orð, forði	3															
að stríða einhverjum	to tease someone		2													að stríða		
Ertu að stríða mér?	Are you teasing me?	að stríða	2															
Ekki stríða honum.	Don't tease him.	að stríða	2															
Jesús Kristur	Jesus Christ		3															
We are good friends.	Are we friends?	vinur	2															
tannkrem	toothpaste		2															
tannkremið	the toothpaste		2															
Ég er með *bólur*.	I have *zits/acne*.	bóla	3													bóla		
Hann er *þolinmóður*.	He is patient.	að þola	3													þolinmóður		
Hann er *óþolinmóður*.	He is impatient.	þolinmóður	3													óþolinmóður		
Takk fyrir *þolinmæðina*.	Thank you for *the patience*.	þolinmæði	3															
þolinmæði	patience	þolinmóður	3															
Fyrirgefðu hvað ég er óþolinmóður.	Forgive me for being so impatient.	óþolinmóður, að fyrirgefa	3															
Af hverju er hann svona vondur við mig?	Why is he so mean towards me?	vondur	1															
að fylgjast með	to pay attention, to follow something closely	að fylgja	2															
Fylgist þú með boltanum?	Do you pay attention to football/handball/basketball?	að fylgjast með, bolti	2															
Ertu að fylgjast með?	Are you paying attention?	að fylgjast með	2															
Ég er í grænum sokkum.	I'm wearing green socks.	grænn, sokkur	2															
dáinn	deceased, dead	að deyja	3	dauður			->		"Dáinn" is far more respectful than "dauður", but not as respectful as "látinn".									
Hann er látinn.	He is deceased.	að látast	3				->		"Látinn" is more respectful than "dáinn".							látinn		
dauður	dead; totally dead	að deyja	3						It's rude to use this term to refer to people who are deceased, instead you should use "dáinn".									
að deyja	to die		3															
Mamma mín er dáin.	My mother is deceased.	dáinn	3															
Mamma mín dó í fyrra., Mamma mín lést í fyrra.	My mother died last year.	að deyja, að látast, í fyrra	3															
í fyrra	last year	fyrri	2															
Hann lést í gær.	I passed away yesterday.	látinn	3				->											
að látast	to pass away, to die	látinn	3				<-											
að látast	to pass away, to die; to pretend	látinn	3				->											
að þykjast, að látast	to pretend	að þykjast, að látast	3				<-											
að þykjast	to pretend	að þykja	3				->											
Taktu þinn tíma.	Take your time.		2										bh					
Mjólkin er búin.	We're out of milk.	búinn, mjólk	1															
smjör	butter		3															
Áfram með smjörið.			5															
Áttu kött?	Do you own a cat?	að eiga, köttur	1															
Ég á tvo hunda.	I own two dogs.	að eiga, hundur	1															
fimmhundruðkall	500 ISK, 500 ISK bank note	hundraðkall	2				->											
tíkall	10 ISK coin	hundraðkall	4															
túkall	2 ISK coin (no longer in existance)		6															
hundraðkall	100 ISK coin		2															
Haltu kjafti.	Shut up		3				->		More rude than "þegiðu".			rude						
að muna	to remember		1	að munu														
Ég man ekki eftir því.	I don't recall/remember that.	að muna	1															
Ég mundi ekki eftir því.	I didn't remember that.	að muna	2															
Ég man ekki hvernig maður segir X.	I don't remember how you say X.	að muna, maður	1															
Það búa hundrað manns í þessum bæ.	There are 100 people who live in this town.	maður, hundrað, að búa	1							"Menn" in the [[first case]] means "men" in this context, but "people" if it's in the [[fourth case]].								
Það eru fimm *manns* hérna.	There are 5 *people* here.	maður, fimm	1							"Menn" in the [[first case]] means "men" in this context, but "people" if it's in the [[fourth case]].								
Það eru fimm *menn* hérna.	There are 5 *men* here.	maður, fimm	1	Það eru fimm manns hérna.						"Menn" in the [[first case]] means "men" in this context, but "people" if it's in the [[fourth case]].								
Ég gleymdi því.	I forgot it.	að gleyma	2															
Þetta er ömurleg mynd., Þetta er hræðileg mynd.	This is a terrible/awful film.	ömurlegur	1															
ömurlegur	terrible, extremely bad, awful		1				->			pitiful, dismal								
hræðilegur	terrible, extremely bad, awful	hræddur	1				->			frightening								
hræddur	scared		3															
Þú lítur hræðilega út.	You look terrible., You look like shit.	hræðilegur, að líta út	2															
Hvernig lítur þetta út?	How does this look?	að líta út	1															
Ég er sammála.	I agree.	samur, mál	1													sammála		
Ég er ósammála.	I disagree.	sammála	1													ósammála		
Ég er sammála honum.	I agree with him.	sammála	1															
Ég er ekki sammála henni.	I don't agree with her.	sammála	1															
Mér líður ömurlega., Mér líður hræðilega.	I feel terrible., I feel like shit.	ömurlegur, hræðilegur	2															
Er þetta hann?	Is this him?		1															
Mér líður betur.	I feel better.	betur	1															
Ég er betri.	I am better.	góður	1															
Mér líður eins og ég sé betri en hann.	I feel as if I am better than him.	góður	3															
Hann er ekki hræddur við hunda.	He's not afraid of dogs.	hræddur, hundur	2															
Hann er mjög góður að dansa.	He's very good at dancing.		1															
gaur	dude		2															
Ég átti afmæli í gær.	It was my birthday yesterday.	að eiga, afmæli, í gær	2															
afmæli	birthday		2															
afmælið	the birthday	afmæli	2															
afmælið mitt	my birthday	afmæli	2															
Af hverju er hún svona góð í fótbolta?	Why is she so good at football?	góður, fótbolti	1															
Hann á afmæli.	It's his birthday.	að eiga, afmæli	2															
Þú átt afmæli á morgun.	It's your birthday tomorrow.	að eiga, afmæli	2															
Hvað ætlar þú að kaupa úti í búð?	What are you going to buy in the grocery store?	að kaupa, búð	1															
Ætlarðu að elda í kvöld?	Are you going to cook this evening?	að elda, í kvöld	1															
eldur	a fire		1															
að elda	to cook	eldur	1															
Hvað ætlarðu að gera á Íslandi?	What are you going to do in Iceland?		1															
að dansa	to dance		3															
dans	a dance	að dansa	3															
Veistu hver þetta er?	Do you know who this is?	að vita, hver	1															
Ertu í stuði fyrir göngutúr?	Are you in the mood for going for a walk?	í stuði, göngutúr	1															
Skilurðu?	Do you understand?	að skilja	1															
Ég skil þetta ekki.	I don't understand this.	að skilja	1															
Þú skilur mig.	You understand me.	að skilja	1															
Ég bý ekki lengur í Reykjavík.	I no longer live in Reykjavík.	að búa, lengi	1															
Hún er góð í því.	She is good at it.	góður	1															
að kíkja	to have a look at something, to have a quick look somewhere		2															
að kíkja í heimsókn	to go for a short visit to someone	að kíkja, heimsókn, á eftir	2						The word "kíkja" here means that you're offering them to come over for a short visit, which sounds more polite.									
Viltu kíkja í heimsókn á eftir?	Do you want to come over for a quick visit later today?	að kíkja í heimsókn	2						The word "kíkja" here means that you're offering them to come over for a short visit, which sounds more polite.									
Er hann farinn?			2															
Eru strákarnir farnir?			2															
Ég man ekkert eftir því.			1															
meiddur, slasaður			4															
Er einhver heima?			1															
Það er einhver heima.			1															
Hann vill fá að tala við þig.			2															
Drífðu þig.	Hurry up!		3													að drífa sig		
Drífa sig!	Hurry up!, Come on now\, one has to hurry up!	að drífa sig	5				->		This phrase is impersonal and means "One has to hurry up", but saying it is an order, usually to a child.									
Geturðu ekki drifið þig?	Can't you hurry up?	að drífa sig	3															
Það er ósanngjarnt.	That's unfair.	sanngjarn	3													ósanngjarn		
Það er ekki sanngjarnt.	That's not fair.	sannur, gjarn	3													sanngjarn		
Ég er verri en síðast.	I'm worse than last time.	vondur, síðastur	1															
Til hamingju með daginn.	Happy birthday!, Congratulations on the day.	til hamingju	2				->											
til hamingju	congratulations	hamingja	2															
hamingja	happiness		2															
Hann er hamingjusamur.	He is happy.	hamingja	2				->											
Það tekur því ekki.			3													að taka því		
Hann tók því illa.			3													að taka einhverju		
allt annar			3															
Hann býr í allt öðrum heimi.			3															
Og hvað með það?	And so what?		1															
Það vita það allir.	Everybody knows it.		1															
Það vita allir af því.	Everybody knows about it.		1															
Hvernig líður þér?	How are you feeling?, How do you feel?	að líða	1															
Tíminn líður hratt.	The time passes quickly.	að líða, hraður	1															
hreimur	a foreign accent		2															
Tíminn líður hægt.	The time passes slowly.	að líða, hægur	1															
Tíminn leið hratt.	The time passed quickly.	Tíminn líður hratt.	2															
Tíminn leið hægt.	The time passed slowly.	Tíminn líður hægt.	2															
hægt	slow; doable, possible, achievable		1													hægur		
hratt	quickly, quick, fast		1													hraður		
hækjur	crutches (to help you walk when you are injured)		4									health				hækja		
Ég er á hækjum.	I have to use crutches (to help me walk).	hækjur	4									health						
Takk fyrir mig., Takk fyrir matinn.	(phrase said when you finish eating food someone else has made for you)		2															
Maður verður víst *að fylgja fyrirmælum lögreglu*.	I suppose that one does have to *follow police orders*.	vís, fyrirmæli, lögregla	4															
Það gekk illa.	It went badly.	að ganga, illa	2															
It went well.	It went well.	að ganga, vel	2															
Tölvan mín virkar ekki lengur.	My computer no longer works., My computer no longer functions.	að virka, tölva, lengi	2															
Hann er frægur.	He is famous.		1													frægur		
Þessi mynd er mjög fræg.	This movie is very famous.	mynd, mjög, frægur	1															
mynd	picture; movie		1															
myndin	the picture; the movie	mynd	1															
Ég er bara að grínast.	I just joking.	að grínast	2															
Geturðu *tekið upp* tónleikana mína?	Can you *record* my concert?		3							Can you take me up.						að taka upp		
tónleikar	a concert; concerts		2						"Tónleikar" is always in plural although it can refer to a single concert.									
tónleikarnir	the concert; the concerts	tónleikar	2															
Við ætlum að halda tónleika á morgun.	We're going to give a concert tomorrow.	tónleikar	2															
Ég ætla bara að taka því rólega.	I am just going to take it easy.	rólegur	1.8															
að skipta sér af	to stick one's nose into matters, to get involved with things that are not your concern	að skipta	3															
Ekki skipta þér af því.	Don't stick your nose into it., Don't get involved with it (as it is not your concern).	að skipta sér af	3															
Þarftu hjálp?	Do you need help?	hjálp, að hjálpa, að þurfa	2															
Hann er vinsæll.	He is popular.	vinur, sæll	1													vinsæll		
Get ég fengið *pínku* meira?	Can I get *just a tiny bit* more?	meira	2	bleikur			->	Used in colloquial speech.								pínku		
Ég kann *pínku* íslensku.	I know a *teeny tiny bit* of Icelandic.	pínku, íslenska, að kunna	2				->	Used in colloquial speech.										
Ég ætla bara að fá mér *pínku pons*.	I am just going to have a *teeny tiny bit*.	pínku, að fá sér	2				->	Used in colloquial speech.										
Ég kann *pínulitla* íslensku.	I know a *teeny tiny bit* of Icelandic.	lítill, pínulítill	2				->	Used in colloquial speech.										
Hún er alltaf að skipta sér af hlutum sem koma henni ekki við.	She's always sticking her nose into things that are none of her business.	að koma einhverjum við, að skipta sér af	3															
að skipta	to change, to switch, to swap, to exchange; to divide		2	skip, skap														
að skipta máli	to matter, to be important	að skipta, mál	2															
Skiptir það máli?	Does that matter?	að skipta máli	2															
Það skiptir ekki máli.	That doesn't matter.	að skipta máli	2															
Það skiptir engu máli.	That doesn't matter at all.	að skipta máli, enginn	2						"Enginn" can be used to add more emphasis than "ekki".									
Getum við skipt yfir á ensku?	Can we switch to English?	að skipta	2															
Ég þýddi textann yfir á ensku.	I translated the text to English.	að þýða, texti	2															
að skiptast á	to take turns doing something; to exchange things		3															
Getum við skipst á að nota tölvuna?	Can we take turns using the computer?	að skiptast á	3															
Viltu skiptast á?	Do you want to take turns (with me using this item)?	að skiptast á	3															
sveittur	sweaty		2															
Dettur þér eitthvað í hug?	Can you think of anything?, Do you have any ideas?	að detta, hugur	2													að detta í hug		
Mér datt í hug að fara í sund.	The idea occurred to me that I could go swimming., I was thinking about going swimming.	að detta í hug	2															
Mér datt í hug að við gætum hist á morgun.	I was thinking that we could meet up tomorrow., It occurred to me that we could meet up tomorrow.	að detta í hug	3															
Mér dettur ekkert í hug.	I can't think of anything., Nothing comes to mind.	að detta í hug	2															
Ertu viss?	Are you certain?	viss	2													viss		
Ég er ekki viss.	I'm not sure.	viss	2															
Hún er ekki viss um það.	She's not sure about it.	viss	2															
Það er ekki víst.	That is not certain.	vís	2		"Víst" is the [[neuter]] form of "vís". The term "viss" is related but describes persons being certain about something.													
Hvað gerðirðu við hann?	What did you do to him?	að gera	2	að gera við einhvern												að gera við einhvern		
Geturðu *gert við* tölvuna mína?, Geturðu *lagað* tölvuna mína?	Can you *fix* my computer?	að gera, að laga	2													að gera við eitthvað		
að laga, að gera við	to fix		2	lag, að syngja			<-									að laga		
að gera við	to fix; to do something to someone		2				->											
Ég þarf að láta laga bílinn minn., Ég þarf að láta gera við bílinn minn.	I need to get my car fixed.	að laga, að gera við eitthvað	2															
fyrirlitning	contempt, disdain		6															
Mér finnst kaffi líka gott.	I also like coffee.	líka, kaffi, að finnast	1															
höfuð, haus	a head		2															
aldrei nokkurn tímann	never ever	nokkur, tími	2													nokkurn tímann		
höfuðverkur, hausverkur	a headache	höfuð, haus, verkur	2															
höfuðið, hausinn	the head	höfuð, haus	2															
klósett	a toilet, W.C.		2	salerni			->		Usually refers to the toilet itself but can also refer to the bathroom. Is more vulgar than "salerni".									
klósettið	the toilet	klósett	2				->											
Klósettið þitt er bilað.	Your toilet is broken., Your toilet doesn't work.	bilaður, klósett	2															
salerni	washroom, W.C., toilet		3				->		Less vulgar than "klósett".									
Hvar er salernið?	Where is the W.C.?, Where is the toilet?	salerni	3															
klósettpappír	toilet paper	pappír, klósett	2															
Ég skil ekki eitt einasta orð.	I don't understand a single word.	einn einasti, orð	2															
að fljúga	to fly		2															
ég flaug	I flew	að fljúga	2.5															
ég flýg	I fly	að fljúga	2															
ég get flogið	I can fly	að fljúga	2															
Ég vona að það verði hægt að fljúga í sumar.			3															
Vaknaðirðu snemma?	Did you wake up early?	að vakna, snemma	2															
Guð minn almáttugur!	Oh my God!	Guð	2.2				->			My all-mighty God!								
Guð minn góður!	Oh my God!	Guð	2				->			My good God!								
hnífur			2															
gaffall			2															
skeið			2															
Ég á eftir að fara í sturtu.		að eiga eftir	3															
að komast að einhverju		að komast	3															
Ég var bara að komast að því áðan.	I just found out earlier today.		3															
að reyna	to try, to attempt		1															
Ég er að reyna.	I'm trying.	að reyna	1															
Ég er að reyna að læra íslensku.	I'm trying to learn Icelandic.	að reyna, íslenska	1															
Ég er að reyna að elda en það gengur ekki vel.	I'm trying to cook but it's not going well.	að reyna, að elda, að ganga	1															
Hvernig gengur?	How is it going with the task that you're working on?, Are you making good progress?	að ganga	1															
að búast við einhverju	to expect something	að búa	2	að búa til												að búast við		
Ég bjóst ekki við því.	I did not expect that.	að búast við	2.2															
Ég býst við því.	I expect that to be so., I assume that it will be so.	að búast við	2															
Býstu við því að vera laus á morgun?	Do you expect that you will be available tomorrow?	að búast við, laus	2															
Við bjuggumst ekki við því að rekast á þig hér.	We did not expect bumping into you here.	að búast við, að rekast á	2.9		að búast við													
hérna, hér	here		1															
þarna, þar	there		1															
núna, nú	now		1															
að segjast vera	to say that one is, to claim to be	að segja	3													að segjast		
Hann sagðist vera kennari.	He said that he was a teacher., He claimed to be a teacher.	að segjast	3															
Hann sagðist hafa verið kennari.	He said that he had (previously) been a teacher., He claimed that he had (previously) been a teacher.	to claim something about yourself	3.3															
Ég ætla kannski að flytja til útlanda.	I am maybe going to move abroad.	útlönd, að flytja, að ætla	1.7															
að flytja	to transport, to move a large object; to move to another house		1	að færa														
að færa	to move something somewhere		1	að hreyfa sig														
að hreyfa sig	to move oneself; to do exercises	að hreyfa	1															
Ekki hreyfa þig.	Don't move!	að hreyfa sig	2															
Mig langar að flytja til Englands.	I want to move to England.	að flytja	1															
Ameríka	America		1.8						Usually referring to the U.S., but can sometimes refer to the continent of the Americas. More colloquial than "Bandaríkin".					-1				
Bandaríkin	The United States	ríki, band, að binda, bandalag	1.9						This term is commonly used, "Ameríka" can also be used colloquially.									
Ríkið	the nickname of the Icelandic state monopoly liquor store Vínbúðin	ríki	4	ríkur					The liquor store is government-run, which is why it is referred to as "the state".	the state				-0.1				
Ég er í Ameríku.	I'm in America.	Ameríka	1															
Ég er í Bandaríkjunum.	I'm in the United States.	Bandaríkin	1.9		Bandaríkin													
Bandaríkin eru stórt land.	The United States are a large country.	Bandaríkin, stór, land	1															
Ég flutti til Bandaríkjanna fyrir fimm árum.	I moved to the United States five years ago.	Bandaríkin, fyrir, að flytja	2		Bandaríkin													
Ég ætla að fara til Bandaríkjanna.	I am going to move to the United States.	Bandaríkin	1		Bandaríkin													
Mamma þín kemur ekki vel fram við mig.	Your mother does not treat me well., Your mother does not show good behaviour towards me.	að koma fram við	3															
Hann *kemur fram við mig* eins og ég sé einhver fábjáni.	He *treats me* like I'm some idiot., His *behaviour towards me* is as if I were some idiot.	fábjáni, að koma fram við	3															
Hún kemur vel fram við mig.	She treats me well., Her behaviour towards me is good.	að koma fram við	3															
Ég er ekki með góðan orðaforða.	I don't have a good vocabulary.	góður, orðaforði	2															
flugvél	an airplane	vél	1															
flugvélin	the airplane	flugvél	1															
Ég er kominn í flugvélina.	I have made my way into the airplane., I am now in the airplane., I have arrived to the airplane.	kominn, flugvél	2		flugvél													
Ég er í flugvél.	I'm in an airplane.	flugvél	1															
vél	a machine; an engine, a motor		2	vel														
fluga	a fly (the insect)		3	að fljúga														
Það er enginn hérna., Það er ekki neinn hérna.	There's nobody here.	enginn, hérna, ekki neinn	1															
Er einhver hérna?	Is there somebody here?		1															
Hvað tekurðu mikið á tímann?	What is your hourly rate?, How much do you charge for each hour of your time?	að taka, tími, mikill	3.3															
að vinna	to work; to win		1															
vinna	a job, work	að vinna	1	vinur														
vinnan	the job, the work	vinna	1															
Ég er á leiðinni í vinnuna.	I'm on my way to (my) job.	vinna	1															
Ég þarf að fara í vinnuna.	I need to go to (my) job.	vinna, að þurfa	2															
Það er gaman í vinnunni.	It's fun at (my) job., It's fun being at work.	vinna	2															
fyrirtæki	a company		3	tæki														
fyrirtækið	the company	fyrirtæki	3															
Ég á erfitt með að trúa því.	I find that difficult to believe.	að eiga, að eiga erfitt með, að trúa	2.9		að eiga erfitt með													
Það er ekki til neitt kaffi., Það er ekkert kaffi ti.	We're completely out of coffee., There's no coffee available.	að vera til, ekki neinn	2.2															
Það er ekki hægt að gera neitt í því., Það er ekkert hægt að gera í því.	There's nothing one can do about that.	ekki neinn	2.2															
Hann hefur gott vald á tungumálinu.	He has good command over the language., He is quite proficient at the language.	vald, tungumál	4															
Hvað finnst þér um það?	What do you think of that?	að finnast	1															
Mér þykir leitt að hafa brugðist þér.	I am sad for having let you down., I am sad for having failed you.	að bregðast, að þykja leitt	3.6		að bregðast													
Mér þykir það leitt.	I'm sorry about that.	að þykja, leiður	2.1													að þykja leitt		
Ég hef ekki séð eina einustu Star Wars mynd.	I have not seen a single Star Wars film.	einn einasti	2.2															
að svipta	to snatch something away from someone, to deprive someone of something		4															
Hann var sviptur ökuréttindum.	His driver's permit was taken away (by the police/courts).	ökuréttindi, að svipta	4															
Hún svipti sig lífi.	She committed suicide.	líf, að svipta	4.1															
að sjá			1															
Ég sá eftir því.	I regretted it.	að sjá eftir einhverju	3															
á fimm ára fresti	every five years	frestur	2.1															
Ég hef ekki neinn áhuga á þessu., Ég hef engan áhuga á þessu.		áhugi	2															
Mig langar ekki að vera hérna lengur., Ég vil ekki vera hérna lengur.	I no longer want to be here.		2															
Hann er tvítugur.	He is 20 years old.		4									time						
Hún er tvítug.	She is 20 years old		4									time						
Hann er þrítugur			4									time						
Hún er þrítug.			4									time						
Hann er fertugur.			4									time						
Hann er fimmtugur.			4									time						
Hann er sextugur.			4									time						
Hann er sjötugur.			4									time						
Hann er áttræður.			4.4									time						
Hann er níræður.			4.4									time						
Ég er alveg búinn á því.	I'm completely exhausted.	búinn	3.3				->											
Það er svo sem ágætt.	Well\, that's relatively fine.	svo sem	3.2				->		"Svo sem" only serves to add nonchalance to the sentence.					-1				
Ég veit svo sem ekki alveg hvað ég ætla að gera.	Well\, I don't quite know what I intend to do.	svo sem	3.2				->		"Svo sem" only serves to add nonchalance to the sentence.					-1				
Fyrirtækið fór á hausinn.	The company went bankrupt.	fyrirtæki, haus	3.3		að fara á hausinn											að fara á hausinn		
að sýna	to show someone something		1.9															
Mér sýnist ég vera laus á morgun.	As far as I can see\, I am free tomorrow., It appears to me that I am free tomorrow.	að sýna, laus	2.2													að sýnast		
Splæsirðu?	Your treat?, Are you going to be the one to splurge on this item for me?, Will you be paying for me?		3.5		að splæsa											að splæsa		
að baktala	to talk negatively about someone behind their back, to slander someone behind their back	bak, að tala	3.8															
að tala illa um einhvern	to speak ill of someone, to talk about someone in a negative manner	að tala, illa	2.8											-1				
að tala vel um einhvern	to speak well of someone, to talk positively about someone	að tala, vel	2.8											-1				
Ekki gleyma mér.	Don't forget me.	að gleyma	2															
Þetta kemur vel út.		að koma, vel, út	2.4													að koma vel út		
Þetta kemur illa út.		að koma vel út, illa	2.4															
Ég veit ekki alveg hvað þú átt við.	I'm don't quite know what you're referring to.	að eiga við, alveg	3															
Það vildi svo til að ...			5															
Hvað á hann við með því?	What does he mean with that?	að eiga við	2		að eiga við													
Ég veit ekki hvað hún átti við með því.	I don't know what she meant by that.	að eiga við	2		að eiga við													
Þegiðu!	Shut up!, Keep quiet!		4		að þegja				This is quite rude, but not as rude as "Haltu kjafti".			rude				að þegja		
lyklaborðið	the computer keyboard	lykill, borð	3													lyklaborð		
Ertu með íslenskt lyklaborð?	Do you have an Icelandic computer keyboard?	lyklaborð, íslenskur	3															
Um hvað snýst þessi mynd?, Hvað snýst þessi mynd um?	What is this movie about?	að snúast um	2															
hlekkur	a link (in a chain or on the internet)		2															
Ýttu á hlekkinn.	Click the link.	hlekkur, að ýta	2															
Þessi hamborgari er góður.	This hamburger is good.	þessi	1		þessi								tvfn					bæta við útskýringum falls
Þetta er góður hamborgari.	This is a good hamburger.	þessi	1		þessi													
Ég ætla að borða þennan hamborgara.	I'm going to eat this hamburger.	þessi	1		þessi													
Það er ostur á þessum hamborgara.	There's cheese on this hamburger.	þessi	1		þessi													
Þetta kaffi er gott.	This coffee is good.	þessi	1		þessi													
Þetta er gott kaffi.	This is good coffee.	þessi	1		þessi													
Það er mjólk í þessu kaffi.	There's milk in this coffee.	þessi	1		þessi													
Viltu þetta kaffi?	Do you want this coffee?	þessi	1		þessi													
Þessi tölva er góð.	This computer is good.	þessi	1		þessi													
Þetta er góð tölva.	This is a good computer.	þessi	1		þessi													
Viltu þessa tölvu?	Do you want this computer?	þessi	1		þessi													
Eru myndirnar á þessari tölvu?	Are the pictures on this computer?	þessi, mynd	1		þessi													hmm
að sjálfsögðu	of course	að segja	1				->		Literally "towards being self-said", it's so obvious that the matter says it itself.									
herbergi	a room		2	her														
herbergið	the room	herbergi	2															
Hann er í herberginu sínu.	He's in his room.	herbergi, sinn	2															
að láta vita			2.8															
Láttu mig vita.	Let me know., Please inform me.		2.9										bh					
Eigum við að segja þetta gott í dag?			2															
að vera reiður út í einhvern			2															
að vera reiður yfir einhverju			2															
Þú ert með krabbamein.	You have cancer.	krabbamein	3.2															
að ala upp	to raise a child, to bring up a child		3															
að alast upp	to grow up somewhere, to be raised in some location, to spend one's childhood in some location	að ala upp	3.1						"Að ala upp" is to raise a child, "að alast upp" ([[middle voice]]) is to '''be''' raised as a child.				mm					
Ég ólst upp í Bandaríkjunum.	I was raised in the U.S., I spent my childhood in the U.S.	Bandaríkin, að alast upp	3.1															
Börnin hans eru illa upp alin.	His children are badly raised., His children have received a bad upbringing.	að ala upp, illa	3															
Ég bjóst hreinlega ekki við því.	I frankly did not expect that.; I simply did not expect that.	hreinn, hreinlega, að búast við	3.1		að búast við													
Manstu?	Do you remember?		1.4															
Þú manst að fara út með ruslið.	Remember to take out the trash.	að muna, rusl	2															
rusl	trash, garbage, junk		2															
ruslið	the trash, the garbage, the junk	rusl	2															
Hann er í rusli yfir því.	He's absolutely devastated by it., He feels terrible about it.	rusl	3.5				->							-0.2				
strax	immediately		1				->											
um leið			2								no							
ferhyrningur	a square (shape)	fjórir	5						"Fer-" is related to "fjórir"					-1				
ferna	a carton	fjórir, ferhyrningur	5						Related to the words "fjórir" and "ferhyrningur".					-1				
mjólkurferna	a carton of milk	ferna, mjólk	5															
Guði sé lof.	Thank God!	Guð	3.3	að lofa						To God be praise., Praise should be given to God.								
ýmislegt			3															
ýmsir			3															
ýmiss konar			3															
Farðu úr sokkunum.	Take off your socks (addressing one person).	sokkur, að fara úr	2.2										bh					
Farið úr skónum.	Take off your shoes (addressing many people).	skór, að fara úr	2.4										bh					
Við erum góðir vinir.	We are good friends.	vinur	2					At least one of the people being described is a male.										
Við erum góðar vinkonur.	We are good (female) friends.	vinkona	2					All of the people being described are female.										
vinkona	a female friend	vinur, kona	1.5						"Vinkona" is pronounced "v'''í'''nkona".									
vinkonur	female friends	vinkona	1.6															
vinkonurnar	the female friends	vinkonur	1.6															
Af hverju ekki?, Hvers vegna ekki?	Why not?		1															
Ég þarf að kúka.	I need to poop.	að kúka, að þurfa	2.8						Rather crude and not something you say unless you are a child or talking to a family member.									
Þarftu að kúka?	Do you need to poop?	að kúka, að þurfa	2.8						Rather crude, something one would only say to a child.									
að pissa			2															
rass	an ass, a butt		2.2															
gat	a hole		2.7	að geta				Referring to a hole in clothes or in the wall, but not a hole in the ground.						-1				
rassgat	an asshole	rass, gat	2.9					Only referring to the anatomical part and not referring to behaving like a jerk.										
að flokka	to sort, to classify		3.5															
baun	a bean		3											-1				
Ég veit ekki baun um Færeyjar.	I don't know anything about the Faroe Islands.	baun, að vita	3				->									ekki baun		
að fara í sturtu	to take a shower		2.5	að sturta	sturta											sturta		
að sturta niður	to flush a toilet		3							to pour down						að sturta		
Ég fór í sturtu áðan.	I took a shower earlier today.	sturta	3															
vandræðalegt	awkward, embarrassing	vandræði	2	hallærislegt						appearing to be in troubles						vandræðalegur		
hallærislegt	uncool, not fashionable, kitsch, embarrassing		3															
Hversu vandræðalegt!, En vandræðalegt!	How awkward!	vandræðalegt	2															
Hann fór án þess að borga.	He went without paying.	án	2													án þess að		
Ég get talað án þess að hreyfa varirnar.	I can talk without moving my lips.	án þess að, vör	2															
varir	lips		2													vör		
varirnar	the lips	varir	2															
Hvað ertu með á vörinni?	What do you have on your lip?	vör	2															
að virða			4															
vanvirðing			4															
Mig grunar...			4															
vörn			4															
Ertu að vinna á morgun?			1															
Mér líður alveg eins.			2															
Líður þér eitthvað öðruvísi?			2															
Mér líður ekkert öðruvísi.			2															
Alveg eins.			2															
að drepast		að drepa	3															
Ég er að drepast úr leiðindum.	I'm dying of boredom.	að drepast, leiðindi, leiðinlegur	3															
að minnsta kosti	at least	kostur, lítill	2	í minnsta lagi						in regards to the smallest choice								
örvhentur	left-handed	hönd	4.2															
rétthentur	right-handed	hönd, rétt	4.2	örvhentur														
tvíburar	twins		4.2											-0.5				
þríburar	triplets, three children carried in the same pregnancy	tvíburar	4.2											-1				
jarðarför	a funeral, a burial	jörð, að fara	3.8				->											
útför	a funeral	að fara, út	3.8				->											
jarðarför, útför	a funeral	jörð, að fara	3.8				<-											
dálítið			2				->		This word is pronounced /dáldið/.									
sjálfsagður			2								no							
að koma í veg fyrir	to prevent	að koma, vegur	3															
bálreiður	furious, very angry	bál, reiður	3.2							angry as a large fire								
Ertu búinn að bursta í þér tennurnar?	Have you brushed your teeth?	að bursta, tönn	3															
Það er hægt.	That's doable., That's achievable., That can be done.	hægur	1															
Það er hægt að keyra hægt.	It is possible to drive slowly., Driving slowly is doable.	hægur, að keyra	1.3															
Það er skrýtið.	That's strange., That's odd.	skrýtinn	1															
að líta niður á einhvern	to look down upon someone, to consider someone as being inferior, to view someone with contempt	að líta, niður	2															
Ég '''kann''' ekki '''við''' að gera það.	I don't '''feel comfortable''' doing that., I feel like I would be breaking social norms by doing that.	að kunna	3	viður, að gera við, Ég kann ekki að gera við það.			->									að kunna við		--
Ég kann vel við hann.		að kunna	3.3	að kunna við			->									að kunna vel við		
Léstu hann vita af því?	Did you let him know about it?	að láta vita, að láta	2.2															
Ég vil ekki tala um það.			1															
Farðu út í búð.	Go to the grocery store.	að fara, búð	2										bh					
Farðu í burtu.	Go away.		2															
að standa við loforð	to keep a promise	að standa, loforð	4															
Leyfðu mér að hugsa.	Allow me to think.		3															
Vantar þig gaffal?	Do you need a fork?, Are you without a fork?	að vanta	3															hmm
Geturðu farið yfir ritgerðina mína?			3															
Ég nenni því ekki.			2															
Hvað skulda ég þér mikið?																		
skuld																		
að skulda																		
Hvernig er veðrið?																		
ófríður			5												yes			
Ég vaknaði fyrir allar aldir í morgun.			5															
að fara í háttinn																		
Ég fer í háttinn sirka tíu.																		
Ég vann í þessu langt fram eftir kvöldi.																		
Ég horfði á helminginn af fyrsta þættinum.																		
Ég nenni ekki að klára þennan þátt.																		
Ég nennti ekki að klára þáttinn.																		
stuð			4											-1				
að vera í stuði		stuð	2													í stuði		
Hún er þriggja barna móðir.	She is the mother of three children.																	
Ég er tveggja barna faðir.	I am the father of two children.																	
Þú ert sá fyrsti sem segir þetta.																		
Það er bannað.																		
Það má ekki.																		
Bríet Bjarnhéðinsdóttir (1856-1940) barðist fyrir réttindum kvenna.																		
kvenréttindi																		
réttindi																		
börn þessara kvenna																		
Ég millifærði frá mínum reikningi inn á reikning hans.																		
Þetta er fimm mínútna myndband.																		
Tökum tíu mínútna pásu.																		
Hvað ertu kominn langt?																		
Ég er kominn með nóg.																		
Ég er glaðvakandi.																		
Hvað er þetta eiginlega?																		
Hvað þarftu eiginlega marga poka?																		
Hvað ertu eiginlega að tala um?																		
óx hratt																		
pipar	pepper																	
paprika	bell pepper, sweet pepper																	
Passaðu þig!																		
tilgangur	purpose	að ganga	3															
Hver er tilgangurinn með þessu?	What's the purpose of this?	tilgangur	3															
tilgangslaust	without a purpose, futile	tilgangur	3												yes			
Ég geri það seinna.	I will do it later.																	
Ég geri það á eftir.	I will do it later today.			Ég geri það seinna.														
Ég á afmæli í dag.	Today's my birthday.																	
Hvenær áttu von á honum?																		
Ég á ekki von á því.		að eiga von á einhverju																
að eiga von á einhverju																		
Þú ræður.	It's up to you., You decide.																	
Það er *þess vegna* sem ég er ...	That is *why* I am ...										no							
Ég mæti.																		
hins vegar																		
Það hentar mér ekki.		að henta																
Hvenær hentar þér að koma?		að henta																
Geturðu sótt mig eftir hálftíma?					að sækja													
að sækja			3															
enska			1															
spænska			3															
danska			3															
þýska			3															
franska			3															
kínverska																		
pólska																		
Í Póllandi er töluð pólska.																		
Hvaða mál er talað þar?																		
lélegur				slæmur														
slæmur																		
Hún er ekki búin að borða neitt í dag.																		
að bjóða einhverjum í kaffi																		
Býður þú fólki oft í kaffi?																		
Ferð þú oft á kaffihús?																		
Ég þarf að fara í bankann.																		
Ég er í bankanum.																		
Ekki skilja mig eftir.																		
Ætlarðu að skilja kartöflurnar eftir?																		
handtekinn																		
Farðu yfir brúna.	Go over the bridge.	brú	4	brúnn														
Ég er á brúnni.	I'm on the bridge.	brú	4	brúnn														
Ég er í brúnni úlpu og stend á brúnni.	I'm wearing a brown parka/jacket/windbreaker and I'm standing on the bridge.		4						Even though they are spelled the same, "the bridge" and "brown" are not pronounced the same.									
úlpa																		
Ég finn ekki úlpuna mína.																		
Ég kemst ekki lengur í gömlu buxurnar mínar.																		
nokkrir menn	a few men															nokkrir		
nokkrar konur	a few women	nokkrir																
nokkur börn	a few children	nokkrir																
að eignast vini	to make friends	að eignast								to acquire a friend								
að eignast barn	to have a child	að eignast								to acquire a child								
Ég á auðvelt með að eignast vini.	It's easy for me to make friends.	að eignast vini, að eiga auðvelt með			að eiga auðvelt með													
að eiga auðvelt með eitthvað	to find something to be easy, for something to be easy for you		2	að eiga erfitt með			->									að eiga auðvelt með		
að eiga erfitt með eitthvað	to have difficultes with something, for something to be difficult for you	að eiga, erfiður, eitthvað	2				->									að eiga erfitt með		
Ég fór með nokkrum vinum mínum að hitta nokkra vini.	I went with a few of my friends to meet a few friends.																	
ég svaf	I slept				að sofa													
við sváfum	we slept				að sofa													
ég sef	I sleep				að sofa													
þú svafst	you slept				að sofa													
að leggja				að leggja sig														
að leggja sig		að leggja																
Ég lagði mig áðan.					að leggja sig													
Mér finnst gott að leggja mig á daginn.					að leggja sig													
Ég legg mig aldrei.					að leggja sig													
Ég lagði bílnum fyrir utan.					að leggja													
Næstum því aldrei.	Almost never.																	
bílpróf	a driver's exam; a driver's license	bíll, próf																
Þarf maður bílpróf til að keyra bíl?																		
Hann er í góðu formi.																		
Ég er í lélegu formi.																		
Ég á nokkra íslenska vini.	I have a few Icelandic friends.																	
Ég á nokkrar bækur.																		
Ég á ekki neinar bækur.																		
nú þegar																		
a\, á\, bé\, sé	What is the name of the letters "A\, Á\, B\, C"?		1				<-					alphabet						
dé\, eð\, e,	What is the name of the letters "D\, Ð\, E\, É"?		1				<-					alphabet						
eff\, gé\, há	What is the name of the letters "F\, G\, H"?		1				<-					alphabet						
i\, í\, joð\, ká	What is the name of the letters "I\, Í\, J\, K"?		1				<-					alphabet						
ell\, emm\, enn	What is the name of the letters "L\, M\, N"?		1				<-					alphabet						
o\, ó\, pé	What is the name of the letters "O\, Ó\, P"?		1				<-					alphabet						
err\, ess\, té	What is the name of the letters "R\, S\, T"?		1				<-					alphabet						
u\, ú\, vaff	What is the name of the letters "U\, Ú\, V"?		1				<-					alphabet						
ex\, ufsilon i\, ufsilon í	What is the name of the letters "X\, Y\, Ý"?		1				<-					alphabet		0.5				
zeta\, þorn\, æ\, ö	What is the name of the letters "Z\, Þ\, Æ\, Ö"?		1				<-		"Z" is not used in Icelandic words.			alphabet						
helmingur	a half		2	hálfur				noun	"Helmingur" is a [[noun]], "hálfur" is an [[adjective]].									
hálfur	half		2					adjective	"Hálfur" is an [[adjective]], "helmingur" is a [[noun]].									
helmingurinn	the half	helmingur	2															
Ég er búinn með helminginn af myndinni. 	I've finished one half of the film.	helmingur	2															
hálfviti	an idiot	hálfur, að vita	2							a half-wit								
Þú ert algjör hálviti!	You are a complete idiot!	algjör, hálfviti	2															
Ég drakk *hálfan bjór* í gær.	I drank *half a beer* yesterday.		2															
Ég drakk *helminginn af bjórnum* í gær.	I drank *half of the beer* yesterday.		2	Ég drakk *hálfan bjór* í gær.														
Ég borðaði einn og hálfan hamborgara.	I ate one and a half hamburgers.	einn og hálfur	2															
einn og hálfur	one and a half	hálfur	2															
Ég er eins og hálfs árs.	I am one and a half years old.		3.5															
Sonur minn er tveggja og hálfs árs.			3.5						"Ár" is here in singular because "a half" is singular.									
Sonur minn er tveggja ára.			3.5															
Hvenær opnar?		að opna	2															
Er opið?		opinn	2															
Hvenær er opið?		opinn	2															
að opna	to open	opinn	2															
Búðin er opin.	The grocery store is open.	opinn	2															
opnaður	opened, that which has been opened	að opna	3						Notice that "opið" means "open", while "opnað" means "opened".									
Það er opið.	It is open.	opinn	2													opinn		
Við opnum klukkan átta.			2															
Það reynir mikið á.																		
Þessi klipping fer þér vel.	This haircut looks good on you., This haircut suits you.		2.7															
á nítjándu öld	in the 19th century																	
að komast í form	to get into shape, to get fit																	
að missa tíu kíló	to lose 10 kilograms																	
á þeim tíma	during that time, during those years																	
viðtal	an interview																	
viðtalið	the interview																	
Ég fór í viðtal.																		
að sækja um	to apply for a job	að sækja					->											
Ég sótti um starf hjá háskólanum.	I applied for a job at the university.																	
staða	a situation; a job position		3	staður														
staður	a place, a location		2															
að auglýsa	to advertise																	
auglýsing	an advertisement	að auglýsa																
auglýsingin	the advertisement	auglýsing																
miðað við	compared to	að miða					->											
að trufla einhvern	to bother someone, to interrupt someone															að trufla		
að reka fyrirtæki	to run a company																	
að reka einhvern	to fire someone (from their job)			að reka fyrirtæki														
Hann var rekinn.	He was fired., He was let go from his job.	að reka einhvern																
Hann er hár.	He is tall.															hár (l)		
Hann er hærri.	He is taller.	hár (l)														hærri		
að hækka	to become taller; for a metric to increase	hærri																
hækkun	an increase	að hækka																
varla neitt	hardly anything, barely anything, almost nothing																	
um eftirmiðdaginn	during the afternoon	eftir, miðja, dagur			eftirmiðdagur					during the after mid-day						eftirmiðdagur		
Ég skil ekki baun.	I don't understand a thing.	baun								I don't understand a bean.								
svipaður	similar to						->											
atvinna	employment	að vinna	3						This term is relatively formal, it is more common to use "vinna" (a job) when speaking.									
atvinnulaus	unemployed	atvinna, laus	3															
atvinnuviðtal	a job interview	atvinna, viðtal	3															
Vantar þig vinnu?	Do you need a job?	að vanta	2															
atvinnuleysi	unemployment	atvinnulaus	4															
Mig vantar ekkert., Mig vantar ekki neitt.	I lack nothing., I don't need anything.																	
Það er ekkert sem mig vantar.	There's nothing that I lack., There's nothing that I need.																	
Klukkuna vantar fimm mínutur í átta.	It's five minutes to 8:00.		6				->		Used by older speakers and in formal speech.									
Þetta gengur eitthvað hálfilla.																		
Ertu búinn að ákveða þig?	Have you decided yet?, Have you made up your mind?	að ákveða	3															
horfði skringilega á mig																		
saman eða í sitt hvoru																		
Ekki séns.																		
Opnaðu næstu síðu.																		
að verða fyrir vonbrigðum, að vera vonsvikinn																		
hvað?	what?		1													hvað		
ég segi	I say		1		að segja													
þú segir	you say		1		að segja													
hún segir	she says		1		að segja													
allt	everything		1		allur													
Það er gott.	It is good., That is good.	það er	1		að vera, góður											gott		
en	but		1															
þú	you		1															
Hvað segirðu gott?	How are you?	þú segir	1						"Segirðu" is made by combining "segir" + "þú".	What do you say that is good?								
En þú?	But what about you?, And you?	en, þú	1															
mamma	a mom, a mother		1															
hún	she		1															
það	it, that		1															
það er	it is, that is	það	1		að vera (to be)													
á	on; onto								Can also mean "a river".									
í	in; into																	
á Íslandi	in Iceland	á			Ísland					on Iceland								